continent_far_north = { # Kobir & Poviss, Hengfors Laegue, part of Redania and Kaedwen
	46 47 48 49 50 51
	68 69 70 71 72 73 74 75 76 77 78 79 80 81 82 83 84 85 86
	89
	102 103 104 105 106 107 108 109 110 111 112 113 114 115
	385 387 388 389
	406
}
continent_north = { # Temeria, Aedrin, Lyria & Rivia, Brugge, Sodden, Mahakam, Dol Blathanna, part of Redania. Cintra and Kaedwen
	5 6 7 8 9 10 11 12 13 14 15 16 17 18 19 20 21 22 23 24
	25 26 27 28 29 30 31 32 33 34 35 36 37 38 39 40 41 42 830
	43 44 45
	52 53 54 55 56 57 58 59 60 61 62 63 64 65 66 67
	87 88
	90 91 92 93 94 95 96 97 98 99 100 101
	116 117 118 119 120 121 122 123 124 125 126 127 128 129 130	131 132 133 134 135 136 137 138 139 140 141 142
	333 334
	338 339
	346
	349 350 351 352 353 354
	374 375 376 377 378 379
	381
	383 384
	386
	390 391
	394
	396 397 398
	400 401
	409
	411 412
}
continent_coastal_north = { # Skellige. Verden, Cidaris, Kercack, part of Cintra
	143 144 145 146 147 148 149 150 151 152 153
	158 159 160 161 162 163 164
	345
	347 348
	382
	392 393
	395
	399
	403
	407
	410
}
continent_brokilon = { # Brokilon
	154 155 156 157 483 484
}
continent_elven_mountains = { # Tir Tochair
	300 301 302 303 304
	335 336 337
	340 341 342 343 344
}
continent_south = { # Maecht, Ebbing, Toussaint, Metinna, Mag Turga, Nazair, Geso
	228 229 230 231 232 233 234 235 236 237 238 239 240 241 242 243 244 245 246 247 248 249 250 251 252 253 254 255 256 257 258 259 260 261 262 263 264 265 266 267 269 268 271 270 272 273 274 275 276 277 278 279 280 281 282 283 284 285 286 287 288 289 290 291 292 293 294 295 296 297 298 299
	305 306 307 309 308 310 311 312 313 314 315 316 317 318 319 320 321 322 323 324 325 326 327 328 329 330 331 332
	355 356 357 358 359 360 361 362 363 364 365 366 367 368 369 370 371 372 373
	402
	404 405
}
continent_near_nilfgaard = { # Vicovaro, Gammera, Etolia
	185 186 187 188 189 190 191 192 193 194 195 196 197 198 199 200 201 202 203 204 205 206 207 208 209 210 211 212 213 214 215 216 217 218 219 220 221 222 223 224 225 226 227
}
continent_nilfgaard = { # Nilfgaard
	165 166 167 168 169 170 171 172 173 174 175 176 177 178 179 180 181 182 183 184
	380
	408
}
